70
3 49 26 2
68 17
GGRRRRRRRRRGGGGGGGGGGGGGGGGGGGGGGGGGGGGG
GGRRRRRRRRRRGGGGGGGGGGGGGGGGGGGGGGGGGGGG
GGGRRRRRRRRRRRRGGGGGGGGGGGGGGGGGGGGGGGGG
GGGRRRRRRRRRRRRRGGGGGGGGGGGGGGGGGGGGGGGG
GGGGRRRRRRRRRRRRRRGGGGGGGGGGGGGGGGGGGGGG
GGGGGRRRRRRRRRRRRRRRGGGGGGGGGGGGGGGGGGGG
GGGGGGRRRRRRRRRRRRRRRGGGGGGGGGGGGGGGGGGG
GGGGGGGRRRRRRRRRRRRRRRRRGGGGGGGGGGGGGGGG
GGGGGGGGRRRRRRRRRRRRRRRRRGGGGGGGGGGGGGGG
GGGGGGGGRRRRRRRRRRRRRRRRRGGGGGGGGGGGGGGG
GGGGGGGGGGRRRRRRRRRRRRRRRRRGGGGGGGGGGGGG
GGGGGGGGGGGRRRRRRRRRRRRRRRRRRGGGGGGGGGGG
GGGGGGGGGGGGRRRRRRRRRRRRRRRRRRRRGGGGGGGG
CCGGGGGGGGGGGRRRRRRRRRRRRRRRRRRRRRGGGGGG
CCGGGGGGGGGGGGRRRRRRRRRRRRRRRRRRRRRRGGGG
CCCCGGGGGGGGGGGRRRRRRRRRRRRRRRRRRRRRRGGG
CCCCGGGGGGGGGGGGGRRRRRRRRRRRRRRRRRRRRRGG
CCCCGGGGGGGGGGGGGGGGRRRRRRRRRRRRRRRRRRGG
CCCCGGGGGGGGGGGGGGGGGGGGGGGRRRRRRRRRRRRG
CCGGGGGGGGGGGGGGGGGGGGGGGGGGGGRRRRRRRRRR
CCGGGGGGGGGGGGGGGGGGGGGGGGGGGGRRRRRRRRRR
GGGGGGGGGGGGGGGGGGGGGGGGGGGGGRRRRRRRRRRR
GGGGGGGGGGGGGGGGGGGGGGGGGGGGRRRRRRRRRRRR
RRRGGGGGGGGGGGGGGGGGGGGGGGGGRRRRRRRRRRGG
RRRRRGGGGGGGGGGGGGGGGGGGGGGGRRRRRRRRRGGG
RRRRRRGGGGGGGGGGGGGGGGGGGGGRRRRRRRRRRGGG
RRRRRRRRRRRRRGGGGGGGGGGGGGRRRRRRRRRRGGGG
RRRRRRRRRRRRRRRGGGGGGGGGGRRRRRRRRRRRGGGG
RRRRRRRRRRRRRRRRGGGGGGGGRRRRRRRRRRRGGGGG
RRRRRRRRRRRRRRRRGGGGGGGRRRRRRRRRRRGGGGGG
RRRRRRRRRRRRRRRRRRRRRRRRRRRRRRRRRRGGGGGG
RRRRRRRRRRRRRRRRRRRRRRRRRRRRRRRRRGGGGGGG
RRRRRRRRRRRRRRRRRRRRRRRRRRRRRRRRGGGGGGGG
GGGGGGGGGGRRRRRRRRRRRRRRRRRRRRRGGRRRGGGG
GGGGGGGGGGGGRRRRRRRRRRRRRRRRRRRRRRRRRRRG
GGGGGGGGGGGGGRRRRRRRRRRRRRRRRRRRRRRRRRRR
GGGGGGGGGGGGGGRRRRRRRRRRRGGGGGGRRRRRRRRR
GGGGGGGGGGGGGGRRRRRRRRRGGGGGGGGGRRRRRRRR
GGGGGGGGGGGGGGRRRRRRGGGGGGGGGGGGGGRRRRRR
GGGGGGGGGGGGGGRRRRRGGGGGGGGGGGGGGGRRRRRR
GGGGGGGGGGGGGGRRRRRGGGGGGGGGGGGGGGGRRRRR
GGGGGGGGGGGGGGRRRRRGGGGGGGGGGGGGGGGGRRRR
GGGGGGGGGGGGGGRRRRRGGGGGGGGGGGGGGGGGRRRR
GGGGGGGGGGGGGGRRRRGGGGGGGGGGGGGGGGGGRRRR
RRRRGGGGGGGGGGRRRRGGGGGGGGGGGGGGGGGGRRRR
RRRRRGGGGGGGGGRRRRGGGGGGGGGGGGGGGGGRRRRR
RRRRRRGGGGGGGGRRRRGGGGGGGGGGGGGGGGRRRRRR
RRRRRRGGGGGGGGRRRRGGGGGGGGGGGGGGGRRRRRRR
RRRRRRRGGGGGGGRRRRRGGGGGGGGGGGGGRRRRRRRG
RRRRRRRRRGGGGGRRRRRRRGGGGGGGGGGRRRRRRRGG
RRRRRRRRRRGGGGRRRRRRRRRRRRRRRRRRRRRGGGGG
RRRRRRRRRRRRRRRRRRRRRRRRRRRRRRRRRRGGGGGG
RRRRRRRRRRRRRRRRRRRRRRRRRRRRRRRRRGGGGGGG
GGRRRRRRRRRRRRRRRRRRRRRRRRRRRRRRRGGGGGGG
GGGGGRRRRRRRRRRRRRRRRRRRRRRRRRRGGGGGGGGG
GGGGGGGGGGGGGGRRRRRRRRRRRRRRRRRGGGGGGGGG
GGGGGGGGGGGGGGGGGRRRRRRRRRRRRRRRRRGGGGGG
GGGGGGGGGGGGGGGGGGGGRRRRRRRRRRRRRRRGGGGG
GGGGGGGGGGGGGGGGGGGGGRRRRRRRRRRRRRRGGGCC
GGGGGGGGGGGGGGGGGGGGGGGRRRRRRRRRRRGGGGCC
GGGGGGGGGGGGGGGGGGGGGGRRRRRRRRRRRRGGCCCC
GGGGGGGGGGGGGGGGGGGGRRRRRRRRRRRRRGGGCCCC
GGGGGGGGGGGGGGGGGGGGRRRRRRRRRRRRGGGGCCCC
GGGGGGGGGGGGGGGGGGRRRRRRRRRRRRRGGGGGCCCC
GGGGGGGGGGGGGGGGGRRRRRRRRRRRRRGGGGGGGGCC
GGGGGGGGGGGGGGGGRRRRRRRRRRRRRGGGGGGGGGCC
GGGGGGGGGGGGGRRRRRRRRRRRRRRGGGGGGGGGGGGG
GGGGGGGGGGRRRRRRRRRRRRRRRGGGGGGGGGGGGGGG
GGGGGGGGRRRRRRRRRRRRRRRGGGGGGGGGGGGGGGGG
GGGGGGGRRRRRRRRRRRRRRRGGGGGGGGGGGGGGGGGG